6 8
0 2 1 0 1 2 4 4
0 0 0 0 3 0 5 0
0 0 0 0 0 0 0 5
0 0 0 0 0 0 1 0
0 0 0 0 0 0 0 1
0 0 0 0 0 0 0 0
